{
    "x": 0,
    "y": 0, 

    "map": [
        1,1,1,1,5,1,1,5,1,81,66,1,6,1,5,1,4,1,1,1,5,10,1,70,1,1,1,1,4,1,1,1,6,1,1,1,1,1,1,1,71,1,1,1,6,1,49,62,78,78,78,78,78,78,78,78,78,78,78,78,78,78,78,78,
        1,4,1,5,6,1,90,1,1,3,81,66,1,6,90,1,12,7,8,1,1,4,1,70,1,6,5,2,9,1,1,6,1,5,1,4,1,5,1,65,82,1,1,5,1,1,1,49,50,50,62,78,78,78,78,78,78,78,78,78,78,78,78,78,
        1,1,2,2,1,1,6,1,2,6,1,81,66,1,1,1,7,8,7,8,7,1,6,81,66,1,1,1,1,1,3,3,1,1,2,1,1,90,1,70,5,1,90,1,5,6,1,1,1,1,49,50,62,78,78,78,78,78,78,78,78,78,78,78,
        1,1,3,1,9,5,1,4,1,6,1,1,81,66,1,6,1,4,1,6,1,2,1,1,70,1,5,1,6,6,2,1,11,1,1,1,5,1,1,70,1,1,10,1,4,1,1,3,4,1,1,1,49,62,78,78,78,78,78,78,78,78,78,78,
        1,2,1,4,1,1,2,1,6,1,90,1,1,70,1,1,3,1,90,1,10,1,4,1,70,1,1,1,5,1,1,1,1,6,1,1,3,1,65,82,5,1,1,6,8,7,1,1,8,1,1,9,1,40,78,78,78,78,78,78,78,63,50,50,
        1,1,1,1,11,1,1,1,1,9,1,6,1,71,1,5,1,6,1,5,2,1,5,1,81,66,1,3,1,8,6,5,4,1,2,1,1,65,82,1,1,1,5,1,7,8,7,8,7,1,3,9,1,56,78,78,78,78,78,78,78,41,4,1,
        1,5,1,85,86,87,86,88,86,87,66,1,1,71,1,1,9,1,1,1,6,1,1,5,1,70,1,1,1,2,1,5,1,1,12,9,1,70,1,1,2,1,1,4,1,1,8,7,1,1,5,1,6,40,78,78,78,78,78,78,78,57,1,4,
        4,1,1,5,1,1,1,6,1,10,81,87,86,83,86,88,86,86,88,89,11,5,1,1,1,73,1,6,1,9,1,1,1,6,1,5,1,70,1,1,9,3,1,1,4,1,7,8,1,2,4,1,1,40,78,78,78,78,78,78,78,41,6,2,
        1,5,1,8,7,8,8,6,12,1,1,6,1,1,1,1,1,1,1,1,1,1,1,10,1,5,1,1,6,8,7,1,90,1,1,1,6,70,5,1,1,1,1,6,1,9,10,1,1,1,1,1,33,46,78,78,78,78,78,78,78,41,8,9,
        6,1,8,7,8,8,7,1,10,1,6,1,1,1,6,1,5,1,1,5,10,1,5,1,9,1,1,2,7,7,8,7,6,1,6,1,1,70,1,1,1,5,1,2,1,3,1,5,1,1,33,34,46,78,78,78,78,78,78,78,78,41,1,4,
        1,6,1,8,1,6,1,1,2,1,3,4,1,9,2,1,1,6,1,1,6,8,1,1,5,1,5,1,7,8,7,7,8,5,1,6,1,73,1,1,10,1,1,1,12,1,1,8,1,33,46,78,78,78,78,78,78,78,78,78,63,55,1,10,
        1,6,2,5,4,1,3,1,1,10,1,6,1,5,12,1,4,1,1,2,1,4,1,1,6,1,1,10,11,6,5,1,6,1,4,1,1,1,1,1,4,1,1,5,1,6,4,1,1,40,78,78,78,63,50,50,50,50,50,62,41,1,90,5,
        1,1,9,1,10,1,6,1,6,6,4,1,5,8,7,8,1,5,1,3,10,5,1,5,1,1,3,6,1,1,1,1,1,3,1,1,6,5,1,8,7,6,1,1,1,1,1,1,33,46,78,78,63,55,1,1,6,1,4,40,57,4,1,11,
        1,5,1,1,90,1,2,4,5,1,1,2,7,7,8,7,1,1,1,1,6,1,1,1,5,1,6,4,1,5,1,5,1,1,1,3,1,1,6,7,8,7,3,1,90,1,5,33,46,78,78,63,55,6,5,1,2,1,1,40,41,9,2,4,
        6,10,1,5,1,1,6,11,1,5,9,1,8,7,1,1,1,5,6,11,1,5,1,10,1,1,1,1,1,12,1,8,1,2,1,10,1,4,11,1,1,7,1,9,1,6,1,40,78,78,78,41,1,10,1,69,1,4,10,40,41,1,2,1,
        1,1,1,1,1,10,1,1,1,1,1,1,1,1,1,1,1,1,1,4,4,1,1,5,6,1,10,5,1,5,1,1,5,5,5,6,1,4,1,5,1,1,1,6,4,1,6,40,78,78,78,41,4,1,85,83,89,2,1,40,41,4,1,90,
        34,34,34,34,34,34,34,34,34,34,34,34,34,34,34,34,34,39,1,1,1,1,90,1,1,1,1,1,1,1,1,1,1,1,1,1,1,1,6,1,9,1,1,1,1,1,1,40,78,78,78,41,1,6,2,8,1,4,1,40,41,1,9,4,
        78,78,78,78,78,78,78,78,78,78,78,78,78,78,78,78,78,47,34,34,34,34,34,34,34,38,34,34,34,34,34,34,34,34,34,34,34,34,34,34,34,34,38,34,34,34,34,46,78,78,78,47,39,11,1,1,90,9,1,40,47,39,6,2,
        78,78,78,78,78,78,78,78,78,78,78,78,78,78,78,78,78,78,78,78,63,50,50,50,50,50,50,50,50,50,50,50,50,50,50,50,50,50,50,50,50,50,50,50,50,50,50,50,50,50,50,50,55,1,2,6,1,5,1,40,78,41,8,1,
        78,78,78,78,78,78,78,78,78,78,78,78,78,63,50,50,62,78,78,78,41,1,1,1,6,1,4,1,1,4,6,1,1,4,1,1,1,8,1,1,1,1,1,4,1,1,1,1,1,1,1,1,4,1,10,1,12,10,33,46,78,41,1,6,
        50,50,50,50,50,50,50,50,50,50,50,50,50,55,1,5,49,50,62,78,47,34,34,34,34,34,34,34,34,34,34,34,34,34,34,34,35,36,36,36,36,36,36,37,34,34,34,34,34,34,34,34,39,1,4,33,39,1,40,78,78,47,39,1,
        1,1,1,1,1,1,1,5,1,1,1,1,1,5,1,1,1,5,49,50,50,50,50,50,50,62,63,50,50,50,50,50,54,50,50,50,51,52,52,52,52,52,52,53,50,54,50,62,78,78,78,78,41,1,1,49,60,34,44,50,50,62,47,34,
        1,2,1,1,1,5,9,1,6,5,1,1,2,1,6,1,1,1,1,1,5,1,1,1,1,40,41,1,1,1,1,1,6,1,1,1,1,1,1,1,6,1,1,1,6,1,1,49,62,78,78,78,41,4,1,1,49,54,55,1,1,40,78,78,
        1,5,1,5,1,1,1,4,1,1,1,1,2,1,1,1,90,1,3,1,1,10,1,2,1,40,41,1,1,4,1,1,1,6,1,5,1,10,1,1,9,5,1,2,1,1,1,1,40,78,78,78,41,1,1,90,1,4,1,1,33,46,78,78,
        1,1,1,1,1,5,1,1,1,3,1,9,1,4,1,1,11,1,1,1,6,1,5,1,1,56,41,1,5,7,8,7,7,7,1,1,1,1,5,1,1,1,7,1,1,1,1,6,49,62,78,78,47,39,6,1,5,1,6,4,40,78,78,78,
        1,1,1,90,1,1,1,2,1,4,6,1,1,1,5,6,1,1,7,8,1,4,1,9,1,40,41,1,1,1,2,7,8,1,1,1,2,1,1,10,1,1,8,1,3,1,6,1,1,40,78,78,78,47,34,34,34,34,34,34,46,78,78,78,
        5,1,5,1,6,1,9,1,12,1,1,1,3,1,1,1,1,7,8,7,8,7,3,1,5,40,41,1,6,1,1,8,7,4,1,1,1,1,1,1,8,7,8,1,8,7,1,1,6,49,62,78,78,78,78,78,78,78,78,78,78,78,78,78,
        1,1,1,5,1,7,8,5,10,1,2,1,1,1,10,1,1,4,5,8,7,8,2,2,1,40,41,1,1,1,5,9,8,1,12,1,1,1,5,1,1,1,7,8,7,4,1,6,1,1,49,62,78,78,78,78,78,78,78,78,78,78,78,78,
        6,11,5,1,1,3,7,8,7,1,1,1,1,6,1,1,1,5,1,7,3,6,1,12,1,42,43,1,2,1,1,4,3,1,1,1,2,1,1,9,1,1,7,8,1,2,1,1,1,4,1,40,78,78,78,78,78,78,78,78,78,78,78,78,
        5,1,6,6,1,7,8,7,8,4,1,10,1,4,1,1,5,1,7,8,1,1,1,5,1,58,59,6,1,1,1,1,1,1,1,1,1,1,1,1,1,3,3,1,1,1,1,1,2,1,1,49,62,78,78,78,78,78,78,78,78,78,78,78,
        1,4,1,1,7,8,1,1,1,1,1,1,12,1,1,1,1,1,7,1,4,1,1,1,4,74,75,1,1,1,5,1,1,5,1,7,1,1,4,2,1,1,11,1,1,1,1,1,9,1,1,1,49,62,78,78,78,78,78,78,78,78,78,78,
        1,2,1,1,8,6,1,5,6,1,1,5,1,1,4,1,1,9,1,1,1,1,10,1,1,40,41,1,5,1,1,8,7,8,8,7,1,1,1,1,1,1,1,8,5,1,1,1,1,1,5,1,1,56,78,78,78,78,78,78,78,78,78,78,
        6,1,9,1,4,4,11,10,1,1,6,1,1,4,1,1,5,1,1,4,5,1,8,3,1,40,41,1,1,8,1,1,8,7,7,1,1,5,1,1,1,1,2,1,1,2,1,5,6,1,12,1,1,49,62,78,78,78,78,78,78,78,78,78,
        1,6,1,1,10,6,1,1,1,1,2,1,7,1,1,6,1,1,1,1,1,9,4,1,1,40,41,1,1,2,1,4,7,8,3,3,1,1,1,5,1,1,1,1,1,1,1,1,1,1,1,1,6,1,49,62,78,78,78,78,78,78,78,78,
        1,1,1,1,1,1,6,1,6,1,1,7,8,1,1,1,8,8,1,1,6,1,1,1,1,40,41,1,1,1,1,11,1,1,1,1,1,6,1,1,1,5,1,8,7,4,1,1,90,1,2,4,4,1,1,49,62,78,78,78,78,78,63,50,
        1,1,5,1,2,1,3,1,1,10,1,1,7,8,7,7,8,1,1,5,1,1,5,6,1,40,41,1,1,1,5,1,1,1,1,4,1,1,5,1,1,1,1,5,8,7,1,10,1,1,1,1,11,3,10,1,49,62,78,78,78,63,55,1,
        5,1,1,1,1,4,1,1,1,1,1,6,3,1,1,8,7,1,6,1,1,6,1,1,1,77,60,39,1,5,1,1,3,1,1,1,1,1,1,6,5,1,1,1,1,1,6,1,1,5,1,9,1,1,1,1,1,40,78,78,78,41,1,6,
        1,1,1,1,1,1,1,1,9,1,3,1,1,1,1,7,7,1,1,1,10,1,6,5,1,1,40,41,1,10,1,1,4,1,5,1,1,1,1,1,1,10,1,1,5,1,6,1,1,5,4,1,1,1,2,5,1,56,78,78,63,55,1,1,
        1,1,1,4,1,1,1,1,2,1,1,1,1,1,11,8,1,1,6,1,4,5,7,1,7,1,40,41,9,1,2,1,1,1,65,86,87,86,87,86,66,1,5,1,9,1,2,1,5,1,1,1,8,7,1,1,1,49,62,78,41,1,2,1,
        1,5,1,1,1,9,12,4,1,1,5,1,1,2,4,4,1,1,1,3,1,1,8,7,8,6,56,41,1,1,1,5,1,1,73,1,1,1,1,1,81,86,66,1,1,1,1,1,1,6,1,2,9,8,8,7,1,1,40,63,55,1,10,6,
        1,6,1,1,6,6,1,1,1,1,1,1,1,6,1,1,1,2,1,1,1,2,1,1,8,1,40,41,5,1,8,8,1,6,1,1,1,1,5,1,1,1,81,66,1,1,1,3,1,5,1,6,10,5,7,8,7,1,49,55,1,1,11,1,
        1,1,1,6,1,2,6,1,5,1,1,6,1,1,1,1,6,1,10,12,1,2,1,8,7,1,40,41,1,1,5,1,1,5,1,2,1,8,1,1,5,1,1,81,66,1,1,1,6,1,11,5,1,8,8,7,7,1,1,1,6,6,7,8,
        6,6,1,3,1,1,1,1,9,1,69,6,1,5,6,4,1,1,1,5,1,1,3,1,1,1,40,41,1,2,1,1,12,1,1,1,7,7,8,8,7,1,1,1,81,66,1,1,1,1,1,6,1,7,6,1,1,1,5,1,1,7,8,7,
        1,1,4,1,1,1,4,1,1,5,70,1,1,1,1,1,1,2,6,1,1,9,4,1,1,1,40,57,1,1,1,1,90,1,1,7,8,1,8,7,2,3,10,1,1,81,87,66,1,1,1,1,1,5,1,1,5,1,1,2,1,8,2,6,
        5,1,1,5,1,1,1,2,1,1,72,1,1,6,3,9,1,2,1,1,1,1,11,1,1,1,40,41,1,6,1,6,1,1,1,1,1,2,1,1,1,11,12,5,6,1,1,81,87,88,66,1,1,1,1,1,1,1,1,10,1,3,1,1,
        1,1,1,1,1,5,1,1,1,1,70,1,4,1,1,1,1,1,6,4,1,6,1,4,3,1,40,41,1,1,1,1,1,1,2,1,1,1,6,9,4,1,1,1,2,1,1,1,1,1,81,86,86,88,86,88,86,86,66,1,1,1,1,1,
        1,1,2,1,4,11,1,3,6,1,81,66,1,1,2,1,7,7,8,1,1,1,1,1,10,2,77,60,39,1,1,2,1,1,1,5,1,90,1,1,1,1,6,4,4,1,1,5,1,6,1,1,1,5,1,1,1,5,81,88,86,87,86,87,
        1,3,1,1,1,6,1,1,4,1,1,70,1,1,7,8,4,8,7,1,1,90,1,1,6,1,1,40,41,9,1,3,1,1,6,5,1,1,1,6,1,1,1,1,1,6,5,1,1,1,1,5,1,1,1,1,1,1,1,1,1,1,1,10,
        1,5,1,3,1,2,1,1,1,1,1,81,66,1,6,7,8,7,5,1,1,2,6,1,6,9,1,40,41,1,1,11,5,9,1,1,1,1,33,34,34,39,1,1,9,1,1,2,6,5,1,2,4,1,6,5,1,12,1,1,1,5,1,1,
        1,6,1,6,1,1,1,3,12,1,1,1,70,1,1,5,7,7,1,1,9,1,1,1,1,1,1,40,41,5,1,1,1,33,34,34,34,34,46,78,78,47,34,34,39,1,1,1,1,1,1,1,1,1,5,1,90,1,9,5,11,1,1,5,
        1,1,9,1,6,5,1,1,1,6,5,1,81,66,1,1,1,1,4,1,1,1,1,4,1,1,3,42,43,1,1,33,34,46,78,78,78,78,78,78,78,78,78,78,47,34,39,1,1,9,6,3,1,1,1,1,1,1,1,1,2,1,10,5,
        1,1,2,1,1,1,6,2,1,1,7,1,1,81,66,1,1,6,1,10,5,1,5,1,9,6,1,58,59,6,33,46,78,78,78,78,78,78,78,78,78,78,78,78,78,78,47,39,1,5,1,11,1,1,10,1,1,3,1,1,1,1,1,1,
        1,3,1,6,90,1,1,1,1,5,7,7,7,1,81,66,1,1,5,1,1,1,1,4,1,2,1,58,59,1,40,78,78,78,78,78,78,78,78,78,78,78,78,78,78,78,78,47,39,1,1,1,6,1,1,1,1,1,4,1,1,5,2,1,
        10,1,1,10,1,11,5,1,1,1,1,7,7,1,1,81,66,1,1,5,1,1,8,7,8,1,5,58,59,1,40,78,78,78,78,78,78,78,78,78,78,78,78,78,78,78,78,78,41,1,1,2,1,9,7,7,1,8,7,1,1,10,3,1,
        1,1,5,1,1,3,1,10,6,1,6,7,5,1,6,1,81,66,1,1,1,6,7,8,7,7,10,58,59,5,40,78,78,78,78,78,78,78,78,78,78,78,78,78,78,78,78,78,41,1,1,12,1,3,7,8,5,7,8,5,1,4,1,1,
        1,1,1,2,1,1,4,1,9,1,1,7,1,1,1,12,1,70,1,1,5,1,1,1,1,4,1,74,75,1,40,78,78,78,78,78,78,78,78,78,78,78,78,78,78,78,78,78,41,5,1,1,1,1,1,7,8,7,7,2,1,1,8,1,
        1,4,1,1,6,1,1,1,2,1,1,3,1,1,9,6,1,81,66,10,1,1,11,1,3,1,5,40,41,1,40,78,78,78,78,78,78,78,78,78,78,78,78,78,78,78,78,78,41,1,10,2,1,5,1,1,7,1,5,5,1,1,7,4,
        6,7,8,8,1,4,8,6,1,90,1,1,1,10,2,1,1,1,70,1,9,4,5,12,1,6,1,40,41,6,40,78,78,78,78,78,78,78,78,78,78,78,78,78,78,78,78,63,55,1,5,1,11,1,90,6,8,1,1,1,3,8,8,4,
        1,8,1,1,2,1,7,1,1,1,1,6,1,1,1,1,1,6,81,66,1,5,1,2,8,1,93,61,76,1,40,78,78,78,78,78,63,50,50,62,78,78,78,78,78,78,63,55,1,1,1,4,6,1,1,1,7,1,10,1,11,7,8,1,
        1,7,5,1,8,7,7,1,6,1,1,1,5,6,4,1,7,1,1,72,1,1,1,1,5,1,40,41,1,1,49,62,78,78,63,50,55,10,1,49,62,78,78,78,78,63,55,1,5,1,1,1,1,5,1,1,1,1,1,90,5,1,2,1,
        1,7,8,7,7,1,1,1,1,1,5,1,1,11,1,7,7,7,5,70,1,1,6,1,9,1,40,41,1,5,1,49,50,50,55,1,1,5,1,1,49,62,78,78,63,55,1,1,1,1,3,1,1,1,1,5,1,5,1,1,1,1,1,5,
        1,1,1,7,8,7,1,1,2,1,1,9,1,5,7,7,7,6,1,81,66,6,1,1,1,93,44,76,1,2,3,1,6,1,1,1,3,1,5,1,12,49,50,50,55,1,6,2,6,7,8,6,8,1,2,6,1,1,1,1,4,1,1,1,
        4,9,2,10,1,1,12,6,1,4,3,1,1,1,10,1,1,1,1,1,70,1,5,1,6,56,41,1,5,7,1,5,1,2,1,5,1,11,10,1,5,1,1,1,10,5,1,1,1,5,7,8,7,1,1,1,1,5,1,1,1,1,1,5,
        1,1,1,1,6,1,1,1,10,1,1,5,1,1,1,5,1,1,5,1,71,1,1,5,1,77,60,92,1,1,2,1,5,1,6,1,5,1,3,1,1,1,6,1,1,1,1,5,1,6,1,1,1,6,1,1,1,1,1,1,1,1,1,1
    ],
    
    "solidMap": [
        0,0,0,0,0,0,0,0,0,0,0,0,0,0,0,0,0,0,0,0,0,0,0,0,0,0,0,0,0,0,0,0,0,0,0,0,0,0,0,0,0,0,0,0,0,0,0,0,0,0,0,0,0,0,0,0,0,0,0,0,0,0,0,0,
        0,0,0,0,0,0,0,0,0,0,0,0,0,0,0,0,1,0,0,0,0,0,0,0,0,0,0,0,0,0,0,0,0,0,0,0,0,0,0,0,0,0,0,0,0,0,0,0,0,0,0,0,0,0,0,0,0,0,0,0,0,0,0,0,
        0,0,0,0,0,0,0,0,0,0,0,0,0,0,0,0,0,0,0,0,0,0,0,0,0,0,0,0,0,0,0,0,0,0,0,0,0,0,0,0,0,0,0,0,0,0,0,0,0,0,0,0,0,0,0,0,0,0,0,0,0,0,0,0,
        0,1,0,0,0,0,0,0,0,0,0,0,0,0,0,0,0,0,0,0,0,0,0,0,0,0,0,0,0,0,0,0,1,0,0,0,0,0,0,0,0,0,0,1,0,0,0,0,0,0,0,0,0,0,0,0,0,0,0,0,0,0,0,0,
        0,0,0,0,0,0,0,0,0,0,0,0,0,0,0,0,0,0,0,0,0,0,0,0,0,0,0,1,0,0,0,0,0,0,0,0,0,0,0,0,0,0,0,0,0,0,0,0,0,0,0,0,1,0,0,0,0,0,0,0,0,0,0,0,
        0,0,0,0,1,0,0,0,0,0,0,0,0,0,0,0,1,0,0,0,0,0,0,0,0,0,0,0,0,0,0,0,0,0,0,0,0,0,0,0,0,0,0,0,0,0,0,0,0,0,0,0,0,0,0,0,0,0,0,0,0,0,0,0,
        0,0,0,0,0,0,0,0,0,0,0,0,0,0,0,0,0,0,0,0,0,0,0,0,0,0,0,0,0,0,0,0,0,0,1,0,0,0,0,0,0,0,0,0,0,0,0,0,0,0,0,0,0,0,0,0,0,0,0,0,0,0,0,0,
        0,0,0,0,0,0,0,0,0,0,0,0,0,0,0,0,0,0,0,0,1,0,0,0,0,0,0,0,0,0,0,1,0,0,0,0,0,0,0,0,0,0,0,0,0,0,0,0,0,0,0,0,0,0,0,0,0,0,0,0,0,0,0,0,
        0,0,0,0,0,0,0,0,1,0,0,0,0,0,0,0,0,0,0,0,0,0,1,0,0,0,0,0,0,0,0,0,0,0,0,0,0,0,0,0,0,0,0,0,0,0,0,0,0,0,0,0,0,0,0,0,0,0,0,0,0,0,0,0,
        0,0,0,0,0,0,0,0,0,0,0,0,0,0,0,0,0,0,0,0,0,0,0,0,0,0,0,0,0,0,0,0,0,0,0,0,0,0,0,0,0,0,0,0,0,0,0,0,0,0,0,0,0,0,0,0,0,0,0,0,0,0,0,0,
        0,0,0,0,0,0,0,0,0,0,0,0,0,0,0,0,0,0,0,0,0,0,0,0,0,0,0,0,0,0,0,0,0,0,0,0,0,0,0,0,0,0,0,0,1,0,0,0,0,0,0,0,0,0,0,0,0,0,0,0,0,0,0,0,
        0,0,0,0,0,0,0,0,0,0,0,0,0,0,1,0,0,0,0,0,0,0,0,0,0,0,0,0,1,0,0,0,0,0,0,0,0,0,0,0,0,0,0,0,0,0,0,0,0,0,0,0,0,0,0,0,0,0,0,0,0,0,0,0,
        0,0,0,0,0,0,0,0,0,0,0,0,0,0,0,0,0,0,0,0,0,0,0,0,0,0,0,0,0,0,0,0,0,0,0,0,0,0,0,0,0,0,0,0,0,0,0,0,0,0,0,0,0,0,0,0,0,0,0,0,0,0,0,1,
        0,0,0,0,0,0,0,0,0,0,0,0,0,0,0,0,0,0,0,0,0,0,0,0,0,0,0,0,0,0,0,0,0,0,0,0,0,0,0,0,0,0,0,0,0,1,0,0,0,0,0,0,0,0,0,0,0,0,0,0,0,0,0,0,
        0,0,0,0,0,0,0,1,0,0,0,0,0,0,0,0,0,0,0,1,0,0,0,0,0,0,0,0,0,1,0,0,0,0,0,0,0,0,1,0,0,0,0,0,0,0,0,0,0,0,0,0,0,0,0,0,0,0,0,0,0,0,0,0,
        0,0,0,0,0,0,0,0,0,0,1,0,0,0,0,0,0,0,0,0,0,1,0,0,0,0,0,0,1,0,0,0,0,0,0,0,0,0,0,0,0,0,0,0,0,0,0,0,0,0,0,0,0,0,0,0,0,0,0,0,0,0,0,0,
        0,0,0,0,0,0,0,0,0,0,0,0,0,0,0,0,0,0,0,0,0,0,0,0,0,0,0,0,0,0,0,0,0,0,0,0,1,0,0,0,0,0,0,0,0,0,0,0,0,0,0,0,0,0,0,0,0,0,0,0,0,0,0,0,
        0,0,0,0,0,0,0,0,0,0,0,0,0,0,0,0,0,0,0,0,0,0,0,0,0,0,0,0,0,0,0,0,0,0,0,0,0,0,0,0,0,0,0,0,0,0,0,0,0,0,0,0,0,1,0,0,0,0,0,0,0,0,0,0,
        0,0,0,0,0,0,0,0,0,0,0,0,0,0,0,0,0,0,0,0,0,0,0,0,0,0,0,0,0,0,0,0,0,0,0,0,0,0,0,0,0,0,0,0,0,0,0,0,0,0,0,0,0,0,0,0,1,0,0,0,0,0,0,0,
        0,0,0,0,0,0,0,0,0,0,0,0,0,0,0,0,0,0,0,0,0,0,0,0,0,0,0,0,0,0,0,0,0,0,0,0,0,0,0,0,0,0,0,0,0,0,0,0,0,0,0,0,0,0,0,0,1,0,0,0,0,0,0,0,
        0,0,0,0,0,0,0,0,0,0,0,0,0,0,0,0,0,0,0,0,0,0,0,0,0,0,0,0,0,0,0,0,0,0,0,0,0,0,0,0,0,0,0,0,0,0,0,0,0,0,0,0,0,0,0,0,0,0,0,0,0,0,0,0,
        0,0,0,0,0,0,0,0,0,0,0,0,0,0,0,0,0,0,0,0,0,0,0,0,0,0,0,0,0,0,0,0,0,0,0,0,0,0,0,0,0,0,0,0,0,0,0,0,0,0,0,0,0,0,0,0,0,0,0,0,0,0,0,0,
        0,0,0,0,0,0,0,0,0,0,0,0,0,0,0,0,0,0,0,0,0,0,0,0,0,0,0,0,0,0,0,0,0,0,1,0,0,0,0,0,0,0,0,0,0,0,0,0,0,0,0,0,0,0,0,0,0,0,0,0,0,0,0,0,
        0,0,0,0,0,1,0,0,0,0,0,0,0,0,0,0,0,0,0,0,0,0,0,0,0,0,0,0,0,0,0,0,0,0,0,0,0,0,0,0,0,0,0,0,0,0,0,0,0,0,0,0,0,0,0,0,0,0,0,0,0,0,0,0,
        0,0,0,0,0,0,0,0,0,0,0,0,0,0,0,0,1,0,0,0,0,0,0,0,0,0,0,0,0,0,0,0,0,0,0,0,0,0,0,0,0,0,0,0,0,0,0,0,0,0,0,0,0,0,0,0,0,0,0,0,0,0,0,0,
        0,0,0,0,0,0,0,0,0,0,0,0,0,0,0,0,0,0,0,0,0,0,0,0,0,0,0,0,0,0,0,0,0,0,0,0,0,0,0,0,0,0,0,0,0,0,0,0,0,0,0,0,0,0,0,0,0,0,0,0,0,0,0,0,
        0,0,0,0,0,0,0,0,1,0,0,0,0,1,0,0,0,0,0,0,0,0,0,0,0,0,0,0,0,0,0,0,0,0,0,0,0,0,0,0,0,0,0,0,0,0,0,0,0,0,0,0,0,0,0,0,0,0,0,0,0,0,0,0,
        0,0,0,0,0,0,0,0,0,0,0,0,0,0,0,0,0,0,0,0,0,0,0,0,0,0,0,0,0,0,0,0,0,0,1,0,0,1,0,0,0,0,0,0,0,0,0,0,0,0,0,0,0,0,0,0,0,0,0,0,0,0,0,0,
        0,1,0,0,0,0,0,0,0,0,0,0,0,0,0,0,0,0,0,0,0,0,0,1,0,0,0,0,0,0,0,0,0,0,0,0,0,0,0,0,0,0,0,0,0,0,0,0,0,0,0,0,0,0,0,0,0,0,0,0,0,0,0,0,
        0,0,0,0,0,0,0,0,0,0,0,0,0,0,0,0,0,0,0,0,0,0,0,0,0,0,0,0,0,0,0,0,0,0,0,0,0,0,0,0,0,0,0,0,0,0,0,0,0,0,0,0,0,0,0,0,0,0,0,0,0,0,0,0,
        0,0,0,0,0,0,0,0,0,0,0,0,1,0,0,0,0,0,0,0,0,0,0,0,0,0,0,0,0,0,0,0,0,0,0,0,0,0,0,0,0,0,1,0,0,0,0,0,0,0,0,0,0,0,0,0,0,0,0,0,0,0,0,0,
        0,0,0,0,0,0,0,0,0,0,0,0,0,0,0,0,0,0,0,0,0,0,0,0,0,0,0,0,0,0,0,0,0,0,0,0,0,0,0,0,0,0,0,0,0,0,0,0,0,0,0,0,0,0,0,0,0,0,0,0,0,0,0,0,
        0,0,0,0,0,0,1,0,0,0,0,0,0,0,0,0,0,0,1,0,0,0,0,0,0,0,0,0,0,0,0,0,0,0,0,0,0,0,0,0,0,0,0,0,0,0,0,0,0,0,1,0,0,0,0,0,0,0,0,0,0,0,0,0,
        0,0,0,0,0,0,0,0,0,0,0,0,0,0,0,0,0,0,0,0,0,0,0,0,0,0,0,0,0,0,0,0,0,0,0,0,0,0,0,0,0,0,0,0,0,0,1,0,0,0,0,0,0,0,0,0,0,0,0,0,0,0,0,0,
        0,0,0,0,0,0,0,0,0,0,0,0,0,0,0,0,0,0,0,0,0,0,0,0,0,0,0,0,0,0,0,1,0,0,0,0,0,0,0,0,1,0,0,0,0,0,0,0,0,0,0,0,0,0,0,0,0,0,0,0,0,0,0,0,
        0,0,0,0,0,0,0,0,0,0,0,0,0,0,0,0,0,0,0,0,0,0,0,0,0,0,0,0,0,0,0,0,0,0,0,0,0,0,0,0,0,0,0,0,0,0,0,0,0,0,0,0,1,0,0,0,0,0,0,0,0,0,0,0,
        0,0,0,1,0,0,0,0,0,0,0,0,0,0,0,0,0,0,0,0,0,0,0,0,0,0,0,0,0,0,0,0,0,0,0,0,0,0,0,0,0,0,0,0,0,0,0,0,0,0,0,0,0,0,0,0,0,0,0,0,0,0,0,0,
        0,0,0,0,0,0,0,0,0,0,0,0,0,0,0,0,0,0,0,0,0,0,0,0,0,0,0,0,0,0,0,0,0,0,0,0,0,0,0,0,0,0,0,0,0,0,0,0,0,0,0,0,0,0,0,0,0,0,0,0,0,0,0,0,
        0,0,0,0,0,0,0,0,0,0,0,0,0,0,1,0,0,0,0,0,0,0,0,0,0,0,0,0,0,0,0,1,0,0,0,0,0,0,0,0,0,0,0,0,0,0,0,0,0,0,0,0,0,0,0,0,0,0,0,0,0,0,0,0,
        0,0,0,0,0,0,1,0,0,0,0,0,0,0,0,0,0,0,0,0,0,0,0,0,0,0,0,0,0,0,0,0,0,0,0,0,0,0,0,0,0,0,0,0,0,0,0,0,0,0,1,0,0,0,0,0,0,0,0,0,0,0,0,0,
        0,0,0,0,0,0,0,0,0,0,0,0,0,0,0,0,0,0,0,0,0,0,0,0,0,0,0,0,0,0,0,0,0,0,0,0,0,0,0,0,0,0,0,0,0,0,0,0,0,0,0,0,0,0,0,0,0,0,0,0,0,0,1,0,
        0,0,0,0,0,0,0,0,0,0,0,0,0,0,1,0,0,0,0,1,0,0,0,0,0,0,0,0,0,0,0,0,0,0,0,0,0,0,0,0,0,0,0,0,0,0,0,0,0,0,1,0,0,0,0,0,0,0,0,0,0,0,0,0,
        0,0,0,0,0,0,0,0,0,0,0,0,0,0,0,0,0,0,0,0,0,0,0,0,0,0,0,0,0,0,0,0,1,0,0,0,0,0,0,0,0,0,0,0,0,0,0,0,0,0,0,0,0,0,0,0,0,0,0,0,0,0,0,0,
        0,0,0,0,0,0,0,0,0,0,0,0,0,0,0,0,0,0,0,0,0,0,0,0,0,0,0,0,0,0,0,0,0,0,0,0,0,0,0,0,0,0,0,0,0,0,0,0,0,0,0,0,0,0,0,0,0,0,0,0,0,0,0,0,
        0,0,0,0,0,0,0,0,0,0,0,0,0,0,0,0,0,0,0,0,0,0,1,0,0,0,0,0,0,0,0,0,0,0,1,0,0,0,0,0,0,1,1,0,0,0,0,0,0,0,0,0,0,0,0,0,0,0,0,0,0,0,0,0,
        0,0,1,0,0,0,0,0,0,0,0,0,0,0,0,0,0,0,0,0,0,0,0,0,0,0,0,0,0,0,0,0,0,0,0,0,0,0,0,0,0,0,0,0,0,0,0,0,0,0,0,0,0,0,0,0,0,0,0,0,0,0,0,0,
        0,0,0,0,0,1,0,0,0,0,0,0,0,0,0,0,0,0,0,0,0,0,0,0,0,0,0,0,0,0,0,0,0,0,0,0,0,0,0,0,0,0,0,0,0,0,0,0,0,0,0,0,0,0,0,0,0,0,0,0,0,0,0,0,
        0,0,0,0,0,0,0,0,0,0,0,0,0,0,0,0,0,0,0,0,0,0,0,0,0,0,0,0,0,0,0,0,0,0,0,0,0,0,0,0,0,0,0,0,0,0,0,0,0,0,0,0,0,0,0,0,0,0,0,0,0,0,0,0,
        0,0,0,0,0,0,0,0,0,0,0,0,0,0,0,0,0,0,0,0,0,0,0,0,0,0,0,0,0,0,0,1,0,0,0,0,0,0,0,0,0,0,0,0,0,0,0,0,0,0,0,0,0,0,0,0,0,1,0,1,0,0,0,0,
        0,0,0,0,0,0,0,0,1,0,0,0,0,0,0,0,0,0,0,0,0,0,0,0,0,0,0,0,0,0,0,0,0,0,0,0,0,0,0,0,0,0,0,0,0,0,0,0,0,0,1,0,0,0,0,0,0,0,0,0,1,0,0,0,
        0,0,0,0,0,0,0,0,0,0,0,0,0,0,0,0,0,0,0,0,1,0,0,0,0,0,0,0,0,0,0,0,0,0,0,0,0,0,0,0,0,0,0,0,0,0,0,0,0,0,0,0,0,0,0,0,0,0,0,0,0,0,0,0,
        0,0,0,0,0,0,0,0,0,0,0,0,0,0,0,0,0,0,0,0,0,0,0,0,0,0,0,0,0,0,0,0,0,0,0,0,0,0,0,0,0,0,0,0,0,0,0,0,0,0,0,1,0,0,0,0,0,0,0,0,0,0,0,0,
        0,0,0,0,0,0,0,0,0,0,0,0,0,0,0,0,0,0,0,0,0,0,0,0,0,0,0,0,0,0,0,0,0,0,0,0,0,0,0,0,0,0,0,0,0,0,0,0,0,0,0,0,0,0,0,0,0,0,0,0,0,0,0,0,
        0,0,0,0,0,1,0,0,0,0,0,0,0,0,0,0,0,0,0,0,0,0,0,0,0,0,0,0,0,0,0,0,0,0,0,0,0,0,0,0,0,0,0,0,0,0,0,0,0,0,0,0,0,0,0,0,0,0,0,0,0,0,0,0,
        0,0,0,0,1,0,0,0,0,0,0,0,0,0,0,0,0,0,0,0,0,0,0,0,0,0,0,0,0,0,0,0,0,0,0,0,0,0,0,0,0,0,0,0,0,0,0,0,0,0,0,1,0,0,0,0,0,0,0,0,0,0,0,0,
        0,0,0,0,0,0,0,0,0,0,0,0,0,0,0,1,0,0,0,0,0,0,0,0,0,0,0,0,0,0,0,0,0,0,0,0,0,0,0,0,0,0,0,0,0,0,0,0,0,0,0,0,0,0,0,0,0,0,0,0,0,0,0,0,
        0,0,0,0,0,0,0,0,0,0,0,0,0,0,0,0,0,0,0,0,0,0,1,0,0,0,0,0,0,0,0,0,0,0,0,0,0,0,0,0,0,0,0,0,0,0,0,0,0,0,0,0,1,0,0,0,0,0,0,0,1,0,0,0,
        0,0,0,0,0,0,0,0,0,0,0,0,0,0,0,0,0,0,0,0,0,0,0,1,0,0,0,0,0,0,0,0,0,0,0,0,0,0,0,0,0,0,0,0,0,0,0,0,0,0,0,0,1,0,0,0,0,0,0,0,0,0,0,0,
        0,0,0,0,0,0,0,0,0,0,0,0,0,0,0,0,0,0,0,0,0,0,0,0,0,0,0,0,0,0,0,0,0,0,0,0,0,0,0,0,0,0,0,0,0,0,0,0,0,0,0,0,0,0,0,0,0,0,0,0,1,0,0,0,
        0,0,0,0,0,0,0,0,0,0,0,0,0,0,0,0,0,0,0,0,0,0,0,0,0,0,0,0,0,0,0,0,0,0,0,0,0,0,0,0,0,0,0,0,0,0,0,0,0,0,0,0,0,0,0,0,0,0,0,0,0,0,0,0,
        0,0,0,0,0,0,0,0,0,0,0,0,0,1,0,0,0,0,0,0,0,0,0,0,0,0,0,0,0,0,0,0,0,0,0,0,0,0,0,0,0,0,0,0,0,0,0,0,0,0,0,0,0,0,0,0,0,0,0,0,0,0,0,0,
        0,0,1,0,0,0,0,0,0,0,0,0,0,0,0,0,0,0,0,0,0,0,0,0,0,0,0,0,0,0,0,0,0,0,1,0,0,0,0,0,1,0,0,0,0,0,0,0,0,0,0,0,0,0,0,0,0,0,0,0,0,0,0,0,
        0,0,0,0,0,0,1,0,0,0,0,0,0,0,0,0,0,0,0,0,0,0,0,0,0,0,0,0,0,0,0,0,0,0,0,0,0,1,0,0,0,0,0,0,0,0,0,0,0,0,0,0,0,0,0,0,0,0,0,1,0,0,0,0,
        0,0,0,0,0,0,0,0,0,0,0,0,0,1,0,0,0,0,0,0,0,0,0,0,0,0,0,0,0,0,0,0,0,0,0,0,0,0,0,0,0,0,0,0,0,1,0,0,0,0,0,0,0,0,0,1,0,0,0,0,0,0,0,0
    ],

    "details": [
        { "x": 1, "y": 3, "type": 1},
        { "x": 16, "y": 5, "type": 1},
        { "x": 31, "y": 7, "type": 1},
        { "x": 10, "y": 15, "type": 1},
        { "x": 21, "y": 15, "type": 1},
        { "x": 36, "y": 16, "type": 1},
        { "x": 45, "y": 13, "type": 1},
        { "x": 56, "y": 18, "type": 1},
        { "x": 34, "y": 22, "type": 1},
        { "x": 5, "y": 23, "type": 1},
        { "x": 18, "y": 32, "type": 1},
        { "x": 3, "y": 36, "type": 1},
        { "x": 40, "y": 34, "type": 1},
        { "x": 50, "y": 39, "type": 1},
        { "x": 34, "y": 44, "type": 1},
        { "x": 20, "y": 50, "type": 1},
        { "x": 59, "y": 48, "type": 1},
        { "x": 4, "y": 54, "type": 1},
        { "x": 52, "y": 56, "type": 1},
        { "x": 34, "y": 61, "type": 1},
        { "x": 13, "y": 63, "type": 1},
        { "x": 45, "y": 63, "type": 1},
        { "x": 13, "y": 63, "type": 1},
        { "x": 59, "y": 62, "type": 1},

        { "x": 27, "y": 4, "type": 2},
        { "x": 43, "y": 3, "type": 2},
        { "x": 52, "y": 4, "type": 2},
        { "x": 22, "y": 8, "type": 2},
        { "x": 28, "y": 15, "type": 2},
        { "x": 13, "y": 26, "type": 2},
        { "x": 37, "y": 27, "type": 2},
        { "x": 46, "y": 33, "type": 2},
        { "x": 31, "y": 38, "type": 2},
        { "x": 14, "y": 41, "type": 2},
        { "x": 2, "y": 45, "type": 2},
        { "x": 50, "y": 49, "type": 2},
        { "x": 60, "y": 56, "type": 2},
        { "x": 2, "y": 61, "type": 2},
        { "x": 55, "y": 63, "type": 2}
    ]
}