{
    "x": 1,
    "y": 0,

    "map": [
        78,78,78,78,63,55,1,1,1,1,6,5,1,1,1,1,1,1,1,1,1,1,1,5,5,6,2,1,1,70,1,1,1,5,5,1,1,4,6,2,1,7,7,4,3,1,1,1,1,65,86,86,87,87,89,1,1,1,1,1,3,3,1,1,
        78,78,78,63,55,1,1,1,1,1,1,2,5,1,11,1,3,3,2,1,1,9,1,1,1,1,1,1,6,72,1,1,1,1,2,6,5,1,8,11,7,7,7,4,1,1,3,65,87,82,1,1,2,6,1,1,1,8,1,4,6,2,1,1,
        63,50,50,55,1,1,85,88,87,66,1,1,1,1,1,1,1,1,2,1,7,1,1,1,65,87,86,88,88,83,88,87,66,1,1,1,8,1,1,1,1,9,6,5,1,1,1,72,1,3,11,3,6,5,1,1,1,1,1,1,1,6,1,1,
        55,1,1,1,1,1,1,1,1,81,88,86,88,66,1,1,8,1,1,1,1,1,65,88,82,1,1,1,1,1,1,1,81,86,86,66,1,1,2,1,1,1,1,1,65,86,87,82,1,1,3,4,1,4,1,8,7,3,1,1,1,4,1,5,
        1,1,1,1,1,1,1,1,1,1,1,1,1,81,87,86,66,1,3,1,65,87,82,1,1,1,1,9,1,1,1,1,1,1,1,81,87,87,86,86,88,88,84,88,82,1,1,1,1,1,6,1,1,7,7,7,6,5,1,1,1,2,2,3,
        1,1,1,1,1,1,12,8,1,3,2,1,1,1,1,1,72,1,1,65,82,1,1,1,1,1,5,5,1,5,3,3,1,1,1,1,1,1,1,1,1,1,70,1,1,1,3,1,9,4,7,4,4,7,8,8,8,8,1,4,5,8,10,1,
        1,1,1,1,1,1,1,1,6,1,3,1,3,3,1,1,81,87,88,82,1,1,1,7,1,8,7,1,4,6,1,1,1,1,1,2,1,1,1,1,1,1,71,1,1,1,1,1,1,1,1,1,1,7,8,6,8,8,1,3,6,3,1,1,
        1,8,1,1,7,4,6,3,8,7,8,8,1,5,1,9,1,1,1,1,1,3,2,7,7,8,7,6,1,1,1,1,11,1,1,1,1,1,1,1,1,1,81,88,86,86,86,86,86,87,66,1,1,4,6,5,1,1,11,1,5,1,65,86,
        1,1,1,3,2,6,3,1,8,8,7,8,7,1,1,9,7,1,1,1,5,7,7,7,8,7,8,1,1,1,1,1,2,2,8,7,7,7,1,1,1,1,12,1,1,1,1,1,1,1,81,66,1,1,1,1,1,1,1,1,65,86,82,1,
        1,1,10,1,1,1,4,2,7,7,8,1,3,1,1,1,1,1,1,4,6,7,7,1,8,5,9,1,1,1,4,2,5,4,7,7,8,6,8,2,1,1,1,1,1,1,1,1,1,1,1,81,86,86,88,87,84,87,86,88,82,1,1,1,
        1,1,1,1,1,8,1,1,1,8,1,8,1,1,1,1,1,1,1,1,1,1,1,2,3,1,1,1,1,1,6,12,1,1,6,2,8,8,7,1,1,1,1,1,1,1,1,1,1,1,1,1,1,1,1,1,70,1,1,1,1,5,2,1,
        1,1,1,1,1,11,1,1,1,8,1,1,1,1,6,1,1,1,1,1,1,3,1,2,2,3,1,1,1,1,5,1,1,6,5,4,7,7,6,5,6,1,1,5,5,6,3,2,2,4,1,1,1,1,5,1,72,1,1,8,8,2,2,1,
        1,1,6,1,1,1,1,1,1,1,1,1,12,1,5,5,5,5,11,1,1,1,1,1,6,3,1,1,1,1,1,1,5,5,1,4,3,5,3,6,5,1,6,4,1,1,1,6,1,6,1,1,1,1,1,1,71,1,1,8,8,7,1,6,
        1,1,1,1,6,1,1,4,6,5,1,1,1,1,5,6,1,1,1,1,1,1,4,6,5,5,2,1,1,1,4,1,4,3,5,4,1,3,5,4,4,5,5,1,3,6,5,1,4,6,1,1,1,9,1,1,70,1,11,1,4,8,1,1,
        1,1,1,1,4,1,5,1,1,4,1,1,1,1,8,1,1,1,1,1,1,1,2,4,5,2,4,1,1,1,1,1,1,1,1,1,6,4,1,1,1,1,3,5,1,1,1,1,1,11,1,1,1,7,1,1,72,1,1,1,1,8,6,1,
        1,1,1,1,5,5,4,1,1,1,6,1,1,1,1,1,1,1,1,1,1,1,5,6,3,6,1,1,1,12,1,1,1,1,1,6,6,1,1,1,1,1,1,1,9,1,1,1,1,1,1,3,1,1,1,11,81,88,66,1,1,1,1,1,
        1,1,1,1,1,2,5,5,1,1,1,12,1,1,1,1,1,1,1,1,3,1,1,6,6,1,1,1,1,1,1,1,1,1,1,1,1,1,1,4,1,1,1,1,1,1,7,1,1,1,1,1,1,1,1,1,1,1,81,86,87,66,1,1,
        1,10,1,1,1,2,4,5,1,1,1,1,1,1,1,1,1,1,1,1,1,7,1,1,1,7,1,1,1,6,1,5,1,1,1,1,9,1,2,6,3,1,1,1,3,2,1,1,1,1,1,1,1,5,2,1,7,1,1,1,1,71,1,1,
        1,5,5,1,1,1,1,5,3,1,1,1,5,1,1,1,1,11,1,1,1,7,1,7,8,7,1,1,6,4,1,5,1,1,1,1,1,1,1,1,2,1,1,4,6,4,1,1,5,6,6,2,3,5,1,1,1,5,1,1,1,81,86,88,
        1,2,6,6,1,1,1,1,3,1,7,7,1,1,1,1,4,3,1,1,7,8,7,7,7,1,1,1,1,1,6,4,1,1,2,4,3,1,1,11,2,1,2,5,4,4,5,1,3,5,1,1,5,1,10,1,1,1,1,1,1,1,1,1,
        1,1,1,2,1,12,1,1,1,1,8,7,1,1,1,5,3,3,1,1,1,10,1,8,1,7,2,1,1,1,6,3,8,8,3,2,2,1,1,1,1,1,1,5,1,1,3,5,4,1,1,1,1,1,1,1,7,7,7,8,1,1,5,1,
        1,1,1,6,1,1,1,8,1,1,1,8,7,7,8,6,3,8,1,1,1,1,1,1,1,1,4,2,3,1,1,1,7,7,1,1,6,1,1,1,8,8,1,1,7,1,2,4,1,1,1,2,2,5,2,4,7,8,7,7,1,1,10,1,
        39,1,1,1,1,4,1,1,1,1,1,6,1,1,7,1,1,1,1,1,33,34,34,34,39,1,1,6,5,1,8,7,8,7,8,7,1,1,1,1,8,7,8,7,8,1,1,4,2,5,1,1,1,1,4,4,1,7,8,2,1,1,1,1,
        47,39,1,1,1,6,1,1,1,1,1,1,2,6,1,1,1,1,1,33,46,78,78,78,47,39,1,1,1,1,1,1,1,1,1,1,1,1,1,1,7,8,7,7,8,1,1,1,3,10,1,1,1,4,3,1,7,7,8,8,1,3,7,1,
        78,47,39,1,1,1,1,1,1,1,1,1,1,2,1,9,1,33,34,46,78,78,78,78,78,47,39,1,8,8,1,1,1,1,1,4,4,2,1,8,1,8,1,8,3,1,1,1,1,1,1,1,1,9,1,1,1,1,1,6,6,5,2,3,
        78,78,47,39,1,8,7,8,1,1,3,6,8,1,1,33,34,46,78,78,78,78,78,78,78,78,41,1,1,9,1,1,1,1,1,1,1,1,1,1,1,1,1,7,5,4,1,1,1,1,1,1,1,1,1,1,2,1,1,4,2,1,2,4,
        78,78,78,41,1,1,1,8,7,1,11,1,1,1,33,46,78,78,78,78,78,78,78,78,78,78,41,1,1,1,93,34,34,34,34,92,1,1,1,1,1,1,1,1,1,3,2,6,1,1,4,5,1,1,1,1,1,1,1,2,1,4,2,1,
        78,78,78,41,1,1,4,5,6,2,1,1,1,1,49,50,62,78,78,78,78,78,78,78,78,78,47,34,34,34,44,50,50,50,50,60,34,34,34,34,92,1,1,1,4,1,7,1,1,1,4,4,1,4,1,1,1,1,9,2,3,6,3,6,
        78,78,78,41,1,1,5,1,4,4,1,1,1,1,1,1,49,62,78,78,78,78,78,78,78,78,63,50,50,50,76,1,1,1,1,77,50,50,50,50,60,34,92,1,1,1,1,1,1,1,3,1,4,3,1,1,1,1,1,6,4,6,3,5,
        78,78,78,41,1,1,1,1,3,2,1,1,1,10,1,1,1,49,62,78,78,78,78,78,78,63,55,1,1,1,1,1,1,7,1,1,4,1,1,1,77,50,60,34,92,1,1,1,1,1,9,6,4,3,6,6,1,1,1,1,1,3,5,2,
        78,78,78,41,1,1,1,1,1,1,1,1,2,1,1,1,1,1,49,50,62,78,78,63,50,55,1,1,1,1,1,2,1,1,1,1,1,1,1,1,1,1,77,50,60,39,1,1,6,1,4,2,1,1,3,5,5,1,4,1,1,1,1,1,
        78,78,63,55,1,1,1,9,1,1,1,7,8,7,1,5,1,1,1,1,49,50,50,55,1,1,1,6,1,1,1,1,1,1,1,1,1,1,1,1,8,1,1,1,40,41,1,1,1,1,1,1,1,1,4,5,6,1,1,1,1,11,4,1,
        78,63,55,1,1,1,1,1,1,2,8,7,7,7,3,2,1,1,1,1,1,5,1,1,1,1,1,2,1,2,1,1,1,1,1,2,1,1,1,5,3,1,1,1,40,41,1,1,1,1,1,1,1,1,1,1,1,1,1,1,1,1,1,1,
        50,55,1,1,1,6,7,6,4,2,1,7,8,1,3,6,5,5,3,10,1,1,1,1,6,5,1,6,2,6,3,5,1,1,1,1,1,1,1,1,4,1,1,8,40,41,8,1,3,10,1,1,1,7,1,1,10,1,1,1,1,1,1,1,
        1,1,1,1,1,7,1,5,1,1,1,1,4,5,3,6,3,2,1,1,1,1,1,2,4,2,2,5,6,4,1,2,1,6,5,1,1,1,1,1,2,4,5,1,40,41,1,1,5,1,1,3,1,1,1,2,1,1,1,2,1,93,34,34,
        1,1,4,3,8,8,5,3,6,1,1,1,1,1,1,1,4,2,1,1,1,11,1,1,1,1,2,4,3,1,1,2,2,2,1,1,1,7,7,8,7,1,4,1,40,41,1,1,1,6,2,3,1,1,1,1,1,1,1,93,34,44,50,50,
        1,1,6,7,8,8,3,6,4,1,1,1,12,9,5,5,2,1,1,1,2,7,5,1,1,1,1,1,1,1,1,3,6,1,1,1,1,1,8,7,8,8,4,1,40,47,39,1,1,5,1,1,33,34,34,34,34,34,34,44,50,76,1,1,
        1,1,1,1,8,8,1,1,1,1,4,1,1,1,1,1,1,1,1,1,1,1,1,1,1,1,1,8,7,1,1,1,1,6,1,1,1,8,8,7,1,1,1,1,77,50,60,34,34,34,34,34,44,50,50,50,50,50,50,55,1,1,7,1,
        1,1,1,6,2,1,1,1,1,1,1,1,1,1,1,1,12,1,1,1,1,1,1,1,6,5,6,1,7,4,1,1,1,5,1,6,1,1,2,1,1,1,1,1,1,1,77,50,50,50,50,50,55,1,1,1,1,1,1,1,1,1,1,1,
        1,1,4,3,1,1,1,1,1,1,1,1,1,8,1,1,1,1,65,87,86,88,86,66,1,1,2,3,7,8,8,7,1,1,1,1,1,1,1,1,1,12,1,1,1,1,1,1,1,1,1,1,1,1,1,1,1,1,8,1,1,1,1,1,
        1,1,1,1,1,1,5,11,1,1,2,1,1,1,65,87,87,87,82,1,1,1,1,70,1,1,7,1,1,5,1,1,1,1,1,1,1,1,1,3,2,1,1,1,1,6,4,5,1,1,1,3,3,1,7,8,7,1,1,1,1,1,1,1,
        1,1,1,1,1,1,2,2,1,6,1,1,1,65,82,1,1,1,1,1,1,10,1,72,1,1,6,1,1,3,3,1,1,1,1,5,5,1,6,5,6,5,1,7,1,1,3,1,1,6,8,1,2,8,8,7,8,8,1,1,11,3,1,1,
        1,1,1,1,1,1,1,6,6,3,10,1,65,82,1,1,1,1,1,1,6,1,1,72,1,1,1,1,7,1,1,8,1,4,1,1,5,4,6,6,2,1,1,1,1,1,5,3,2,5,6,1,3,1,3,7,1,1,5,4,4,1,1,1,
        1,1,1,7,1,1,1,1,1,1,1,1,71,1,1,1,5,4,5,4,4,1,1,72,1,4,5,1,1,1,1,1,1,1,1,12,1,1,1,3,1,1,1,1,1,1,6,2,3,1,3,1,3,4,1,8,1,1,5,5,4,1,1,1,
        1,5,1,5,1,1,1,1,1,1,1,65,82,1,11,1,5,6,2,3,2,1,1,72,1,8,2,1,1,2,1,1,1,1,1,1,5,5,4,5,2,5,6,1,7,8,1,1,1,2,5,1,1,1,1,1,1,4,1,2,6,2,3,5,
        1,1,1,1,1,1,65,86,88,86,87,82,1,1,1,3,4,4,6,1,1,1,1,71,1,1,1,1,1,5,2,6,4,3,5,1,1,5,2,1,1,1,2,1,7,8,1,3,1,4,1,9,1,1,1,1,1,3,4,4,1,1,1,1,
        86,88,87,86,88,88,82,1,1,1,1,1,1,1,1,1,2,2,2,4,1,12,1,71,1,1,1,1,1,5,2,5,5,6,5,8,1,1,1,1,1,1,1,8,8,8,7,8,1,12,1,1,1,1,1,9,1,1,1,8,1,1,1,1,
        1,1,1,1,1,1,1,1,1,1,1,1,1,1,1,1,1,1,1,1,1,1,1,70,1,1,1,12,1,1,1,5,1,1,1,1,2,1,1,1,1,6,1,8,7,6,7,5,1,5,2,1,5,1,1,1,1,1,1,1,1,1,1,1,
        3,2,1,1,1,12,1,1,3,3,3,1,1,5,6,3,1,1,7,1,1,1,1,81,66,1,1,1,1,1,3,1,8,1,1,1,1,1,1,1,6,5,4,3,2,8,7,1,1,5,6,1,6,1,2,1,1,1,1,1,1,1,1,1,
        3,6,1,1,5,4,2,1,3,4,3,1,1,3,1,8,8,4,8,7,1,1,1,1,81,66,1,8,1,1,2,8,8,1,1,1,1,1,1,6,4,3,2,4,3,4,3,1,1,1,4,4,3,6,4,1,1,3,7,1,1,10,1,1,
        2,4,1,1,4,7,3,2,4,5,5,2,1,1,1,7,8,7,8,7,1,1,1,1,1,70,1,1,1,1,1,7,8,1,5,4,5,1,1,1,1,1,1,1,4,6,5,1,1,1,5,5,5,4,6,2,4,7,7,4,3,6,8,1,
        5,4,4,2,7,8,8,4,6,1,1,3,1,1,1,8,8,7,7,8,5,3,1,8,1,81,66,1,1,1,1,7,7,8,7,1,4,1,1,4,1,1,1,4,6,6,1,1,1,1,1,5,1,1,2,4,8,7,7,3,6,1,3,1,
        1,1,8,7,7,8,8,4,1,1,1,1,1,1,1,5,8,7,7,1,1,5,1,8,1,1,71,1,1,10,1,3,1,1,7,7,1,1,1,1,1,1,3,1,1,1,1,2,1,1,6,5,1,1,1,1,8,7,8,7,7,7,1,1,
        1,1,1,1,8,1,1,2,12,1,1,1,1,1,1,1,1,7,7,1,1,3,6,1,4,3,70,1,2,4,5,5,5,6,3,5,1,1,2,1,1,1,1,1,1,1,1,1,1,1,5,7,1,1,1,1,1,4,2,5,5,1,9,1,
        1,10,1,1,7,1,1,1,1,1,1,1,1,3,3,1,1,1,1,1,1,7,5,4,6,1,70,1,2,3,1,6,1,6,3,3,1,1,1,1,1,3,1,1,1,1,1,12,1,3,1,1,1,1,1,6,3,4,5,6,2,5,5,1,
        1,1,5,3,5,1,1,1,1,1,1,1,2,4,5,1,4,4,1,1,1,7,1,1,1,1,70,1,1,8,1,4,1,1,1,3,3,1,1,1,8,2,1,6,5,5,1,1,4,4,1,1,1,6,2,1,1,1,1,1,1,1,4,1,
        1,1,1,5,5,1,1,5,8,1,7,8,1,1,6,2,1,1,1,1,1,1,1,1,1,1,70,1,1,1,1,1,1,1,12,1,1,1,1,1,1,5,3,3,1,1,5,4,4,5,3,5,4,4,2,1,1,1,4,1,8,4,3,1,
        1,1,1,5,2,5,5,6,7,7,7,7,1,1,1,1,9,1,1,1,65,88,86,88,88,87,83,87,87,88,88,66,1,8,1,1,1,6,1,1,1,1,1,1,1,1,2,6,2,4,7,1,1,1,6,3,1,5,5,4,1,1,1,2,
        1,1,1,5,4,2,5,8,7,8,1,1,1,1,1,5,2,1,1,1,72,1,1,1,1,1,1,1,1,1,1,81,66,1,1,1,1,6,4,1,1,5,4,5,1,1,1,1,7,7,7,8,8,8,1,1,3,4,3,1,1,1,2,4,
        1,1,1,3,1,7,7,8,1,1,6,1,8,4,5,3,5,1,12,1,71,1,11,1,1,1,7,1,3,10,1,8,81,87,66,1,1,8,1,4,3,6,3,1,1,1,1,1,2,3,8,1,1,7,1,1,1,11,7,1,1,1,2,1,
        1,1,1,1,3,1,1,1,1,1,4,4,6,3,1,1,5,1,1,65,82,1,6,5,3,8,8,3,4,1,4,1,4,1,72,1,7,7,1,6,4,2,5,1,1,1,1,1,4,6,8,1,3,6,1,1,1,1,1,1,1,10,1,1,
        3,5,1,2,3,1,1,1,1,1,9,3,1,2,6,1,1,1,65,82,1,1,8,1,7,7,8,3,1,1,8,7,5,1,70,1,1,8,7,8,7,1,1,1,1,1,12,9,1,1,6,4,3,1,1,1,1,2,1,1,1,1,1,1,
        2,4,6,5,4,6,3,1,1,1,1,1,1,1,5,12,1,1,72,1,1,1,2,3,1,7,7,1,10,1,1,8,8,1,81,66,1,8,7,1,8,1,1,7,1,1,1,1,1,1,1,1,11,1,1,1,1,1,1,1,1,1,1,1,
        1,3,3,1,1,1,3,3,1,1,1,1,1,1,11,9,1,1,71,4,3,6,4,1,1,1,1,1,1,1,1,8,1,1,1,70,1,1,1,1,1,1,1,1,1,1,1,1,1,1,1,1,1,1,1,1,1,1,1,1,1,1,1,1
    ],
    
    "solidMap": [
        0,0,0,0,0,0,0,0,0,0,0,0,0,0,0,0,0,0,0,0,0,0,0,0,0,0,0,0,0,0,0,0,0,0,0,0,0,0,0,0,0,0,0,0,0,0,0,0,0,0,0,0,0,0,0,0,0,0,0,0,0,0,0,0,
        0,0,0,0,0,0,0,0,0,0,0,0,0,0,1,0,0,0,0,0,0,0,0,0,0,0,0,0,0,0,0,0,0,0,0,0,0,0,0,1,0,0,0,0,0,0,0,0,0,0,0,0,0,0,0,0,0,0,0,0,0,0,0,0,
        0,0,0,0,0,0,0,0,0,0,0,0,0,0,0,0,0,0,0,0,0,0,0,0,0,0,0,0,0,0,0,0,0,0,0,0,0,0,0,0,0,0,0,0,0,0,0,0,0,0,1,0,0,0,0,0,0,0,0,0,0,0,0,0,
        0,0,0,0,0,0,0,0,0,0,0,0,0,0,0,0,0,0,0,0,0,0,0,0,0,0,0,0,0,0,0,0,0,0,0,0,0,0,0,0,0,0,0,0,0,0,0,0,0,0,0,0,0,0,0,0,0,0,0,0,0,0,0,0,
        0,0,0,0,0,0,0,0,0,0,0,0,0,0,0,0,0,0,0,0,0,0,0,0,0,0,0,0,0,0,0,0,0,0,0,0,0,0,0,0,0,0,0,0,0,0,0,0,0,0,0,0,0,0,0,0,0,0,0,0,0,0,0,0,
        0,0,0,0,1,0,1,0,0,0,0,0,0,0,0,0,0,1,0,0,0,0,0,0,0,0,0,0,0,0,0,0,0,0,0,0,0,0,0,0,0,0,0,0,0,0,0,0,0,0,0,0,0,0,0,0,0,0,0,0,0,0,0,0,
        0,0,0,0,0,0,0,0,0,0,0,0,0,0,0,0,0,0,0,0,0,0,1,0,0,0,0,0,0,0,0,0,0,0,0,0,1,0,0,0,0,0,0,0,0,0,0,0,0,1,0,0,0,0,0,0,0,0,0,0,0,0,0,0,
        0,0,0,0,0,0,0,0,0,0,0,0,0,0,0,0,0,0,0,0,0,0,0,0,0,0,0,0,0,0,0,0,1,0,0,0,0,0,0,0,0,0,0,0,0,0,0,0,0,0,0,0,0,0,0,0,0,0,1,0,0,0,0,0,
        0,0,0,0,0,0,0,0,0,0,0,0,0,0,0,0,0,0,0,0,0,0,0,0,0,0,0,0,0,0,0,0,0,0,0,0,0,0,0,0,0,0,1,0,0,0,0,0,0,0,0,0,0,0,0,0,0,0,0,0,0,0,0,0,
        0,0,0,0,0,0,0,0,0,0,0,0,0,0,0,0,0,0,0,0,0,0,0,0,0,0,0,0,0,0,0,0,0,0,0,0,0,0,0,0,0,0,0,0,0,0,0,0,0,0,0,0,0,0,0,0,0,0,0,0,0,0,0,0,
        0,0,0,0,0,0,0,0,0,0,0,0,0,0,0,0,0,0,0,0,0,0,0,0,0,0,0,0,0,0,0,1,0,0,0,0,0,0,0,0,0,0,0,0,0,0,0,0,0,0,0,0,0,0,0,0,0,0,0,0,0,0,0,0,
        0,0,0,0,0,1,0,0,0,0,0,0,0,0,0,0,0,0,0,0,0,0,0,0,0,0,0,0,0,0,0,0,0,0,0,0,0,0,0,0,0,0,0,0,0,0,0,0,0,0,0,0,0,1,0,0,0,0,0,0,0,0,0,0,
        0,0,0,0,0,0,0,0,1,0,0,0,1,0,0,0,0,0,1,0,0,0,0,0,0,0,0,0,0,0,0,0,0,0,0,0,0,0,0,0,0,0,0,0,0,0,0,0,0,0,0,0,0,0,0,0,0,0,0,0,0,0,0,0,
        0,0,0,0,0,0,0,0,0,0,0,0,0,0,0,0,0,0,0,0,0,0,0,0,0,0,0,0,0,0,0,0,0,0,0,0,0,0,0,0,0,0,0,0,0,0,0,0,0,0,0,0,0,0,0,0,0,0,1,0,0,0,0,0,
        0,0,0,0,0,0,0,0,0,0,0,0,0,0,0,0,0,0,0,0,0,0,0,0,0,0,0,0,0,0,0,0,0,0,0,0,0,0,1,0,0,0,0,0,0,0,0,0,0,1,0,0,0,0,0,0,0,0,0,0,0,0,0,0,
        0,0,0,0,0,0,0,0,0,0,0,0,0,0,0,0,0,0,0,0,0,0,0,0,0,0,0,0,0,1,0,0,0,0,0,0,0,0,0,0,0,0,0,0,0,0,0,0,0,0,0,0,0,0,0,1,0,0,0,0,0,0,1,0,
        0,0,0,0,0,0,0,0,0,0,0,1,0,0,0,0,0,0,0,0,0,0,0,0,0,0,0,0,0,0,0,0,0,0,0,0,0,0,0,0,0,0,0,0,0,0,0,0,0,0,0,0,0,0,0,0,0,0,0,0,0,0,0,0,
        0,0,0,0,0,0,0,0,0,0,0,0,0,0,0,0,0,0,0,0,0,0,0,0,0,0,0,0,0,0,0,0,0,0,0,0,0,0,0,0,0,0,0,0,0,0,0,0,1,0,0,0,0,0,0,0,0,0,0,0,0,0,0,0,
        0,0,0,0,0,0,0,0,0,0,0,0,0,0,0,0,0,1,0,1,0,0,0,0,0,0,0,0,0,0,0,0,0,0,0,0,0,0,0,0,0,0,0,0,0,0,0,0,0,0,0,0,0,0,0,0,0,0,0,0,0,0,0,0,
        0,0,0,0,0,0,0,0,0,0,0,0,0,0,0,0,0,0,0,0,0,0,0,0,0,0,0,0,0,0,0,0,0,0,0,0,0,0,0,1,0,0,0,0,0,0,0,0,0,0,0,0,0,0,0,0,0,0,0,0,0,0,0,0,
        0,0,1,0,0,1,0,0,0,0,0,0,0,0,0,0,0,0,0,0,0,0,0,0,0,0,0,1,0,0,0,0,0,0,0,0,0,1,0,0,0,0,0,0,0,0,0,0,0,0,0,0,0,0,0,0,0,0,0,0,0,0,0,0,
        0,0,0,0,0,0,0,0,0,0,0,0,0,0,0,0,0,0,0,0,0,0,0,0,0,0,0,0,0,0,0,0,0,0,0,0,0,0,0,0,0,0,0,0,0,0,0,0,0,0,0,0,0,0,0,0,0,0,0,0,0,0,0,0,
        0,0,0,0,0,0,0,0,0,0,0,0,1,0,0,0,0,0,0,0,0,0,0,0,0,0,0,0,0,0,0,0,0,0,0,0,0,0,0,0,0,0,0,0,0,0,0,0,0,0,0,0,0,0,0,0,1,0,0,0,0,0,0,0,
        0,0,0,0,0,0,0,0,0,0,0,0,0,0,0,0,0,0,0,0,0,0,0,0,0,0,0,0,0,0,0,0,0,0,0,0,0,0,0,0,0,0,0,0,0,0,0,0,0,0,0,0,0,0,0,0,0,0,0,0,0,0,0,0,
        0,0,0,0,0,0,0,0,0,0,0,0,0,0,0,0,0,0,0,0,0,0,0,0,0,0,0,0,0,0,0,0,0,0,0,0,0,0,0,0,0,0,0,0,0,0,0,0,0,0,0,0,0,0,0,0,0,0,0,0,0,0,0,0,
        0,0,0,0,0,0,0,0,0,0,0,0,0,0,0,0,0,0,0,0,0,0,0,0,0,0,0,0,0,0,0,1,0,0,0,0,0,0,0,0,0,0,0,0,0,0,0,0,0,0,0,1,0,0,0,0,0,0,0,0,0,0,0,0,
        0,0,0,0,0,0,0,0,0,0,0,0,0,0,0,0,0,0,0,0,0,0,0,0,0,0,0,0,0,0,0,0,0,0,0,0,0,0,0,0,0,0,0,0,0,0,0,0,0,0,0,0,0,0,0,0,0,0,0,0,0,0,0,0,
        0,0,0,0,0,0,0,0,0,0,0,0,0,0,0,0,0,0,0,0,0,0,0,0,0,0,0,0,0,0,0,0,0,0,0,0,0,0,0,0,0,0,0,0,0,0,0,0,0,0,0,0,0,0,0,0,0,0,0,0,0,0,0,0,
        0,0,0,0,0,0,0,0,0,0,0,0,0,0,0,0,0,0,0,0,0,0,0,0,0,0,0,0,0,0,0,0,0,0,0,0,0,0,0,0,0,0,0,0,0,0,1,0,0,0,0,0,0,0,0,0,0,0,0,0,0,0,0,0,
        0,0,0,0,0,0,0,0,0,0,0,0,0,0,0,1,0,0,0,0,0,0,0,0,0,0,0,0,0,0,0,0,0,0,0,0,0,0,0,0,0,0,0,0,0,0,0,0,0,0,0,0,0,0,0,0,0,0,0,0,0,0,0,0,
        0,0,0,0,0,0,0,0,0,0,0,0,0,0,0,0,0,0,0,0,0,0,0,0,0,0,0,0,0,0,0,0,0,0,0,0,0,0,0,0,0,0,0,0,0,0,0,0,0,0,0,0,0,0,0,0,0,0,0,0,0,0,0,0,
        0,0,0,0,0,0,0,0,0,0,0,0,0,0,0,0,0,0,0,0,0,0,0,0,0,0,0,0,0,0,0,0,0,0,0,0,0,0,0,1,0,0,0,0,0,0,0,0,0,0,0,0,0,0,0,0,0,0,0,0,0,1,0,0,
        0,0,0,0,0,0,0,0,0,0,0,0,0,0,0,0,0,0,0,0,0,0,0,1,0,0,0,0,0,0,0,0,0,0,0,0,0,0,0,0,0,0,0,0,0,0,0,0,0,0,0,0,0,0,0,0,0,0,0,0,0,0,0,0,
        0,0,0,0,0,0,0,0,0,0,0,0,0,0,0,0,0,0,0,0,0,0,0,0,0,0,0,0,0,0,0,0,0,0,0,0,0,0,0,0,0,0,0,0,0,0,0,0,0,0,0,0,0,0,0,0,0,0,0,0,0,0,0,0,
        0,0,0,0,0,0,0,0,0,0,0,0,0,0,0,0,0,0,0,0,0,0,0,0,0,0,0,0,0,0,0,0,0,0,0,0,0,0,0,0,0,0,0,0,0,0,0,0,0,0,0,0,0,0,0,0,0,0,0,0,1,0,0,0,
        0,0,0,0,0,0,0,0,0,0,0,0,0,0,0,0,0,0,0,0,0,1,0,0,0,0,0,0,0,0,0,0,0,0,0,0,0,0,0,0,0,0,0,0,0,0,1,0,0,0,0,0,0,1,0,0,0,0,0,0,0,0,0,0,
        0,0,0,0,0,0,0,0,0,0,0,0,1,0,0,0,0,0,0,0,0,0,0,0,0,0,0,0,0,0,0,0,0,0,0,0,0,0,0,0,0,0,0,0,0,0,0,0,0,0,0,0,0,0,0,0,0,0,0,0,0,0,0,0,
        0,0,0,0,0,0,0,1,0,0,0,0,0,0,0,1,0,0,0,0,0,0,0,0,0,0,0,0,0,1,0,0,0,0,0,0,0,0,0,0,0,0,0,0,0,0,0,0,0,0,0,0,0,0,0,0,0,0,0,0,0,0,0,0,
        0,0,0,0,0,0,0,0,0,0,0,0,0,0,0,0,1,0,0,0,0,0,0,0,0,0,0,0,0,0,0,0,0,0,0,0,0,0,0,0,0,0,0,0,0,0,0,0,0,0,0,0,0,0,0,0,0,0,0,0,0,0,0,0,
        0,0,0,0,0,0,0,0,0,0,0,0,0,0,0,0,0,0,0,0,0,0,0,0,0,0,0,0,0,0,0,0,0,0,0,0,0,0,0,0,0,1,0,0,0,0,0,0,0,0,0,0,0,0,0,0,0,0,0,0,0,0,0,0,
        0,0,0,0,0,0,0,1,0,0,0,0,0,0,0,0,0,0,0,0,0,0,0,0,0,0,0,0,0,0,0,0,0,0,0,0,0,0,0,0,0,0,0,0,0,0,0,0,0,0,0,0,0,0,0,0,0,0,0,0,0,0,0,0,
        0,0,0,0,0,0,0,0,0,0,0,0,0,0,0,0,0,0,0,0,0,0,0,0,0,0,0,0,0,0,0,0,0,0,1,0,0,0,0,0,0,0,0,0,0,0,0,0,0,0,0,0,0,0,0,0,0,0,0,0,1,0,0,0,
        0,0,0,1,0,0,0,0,0,0,0,0,0,0,0,0,0,0,0,0,0,0,0,0,0,0,0,0,0,0,0,0,0,0,0,0,0,0,0,0,0,0,0,0,0,0,0,0,0,0,0,0,0,0,0,0,0,0,0,0,0,0,0,0,
        0,0,0,0,0,0,0,0,0,0,0,0,0,0,0,0,0,0,0,0,0,0,0,0,0,0,0,0,0,0,0,0,0,0,0,1,0,0,0,0,0,0,0,0,0,0,0,0,0,0,0,0,0,0,0,0,0,0,0,0,0,0,0,0,
        0,0,0,0,0,0,0,0,0,0,0,0,0,0,1,0,0,0,0,0,0,0,0,0,0,0,0,0,0,0,0,0,0,0,0,0,0,0,0,0,0,0,0,0,0,0,0,0,0,0,0,0,1,0,0,0,0,0,0,0,0,0,0,0,
        0,0,0,0,0,0,0,0,0,0,0,0,0,0,0,0,0,0,0,0,1,0,0,0,0,0,0,0,0,0,0,0,0,0,0,0,0,0,0,0,0,0,0,0,0,0,0,0,0,0,0,0,0,0,0,0,0,0,0,0,0,0,0,0,
        0,0,0,0,0,0,0,0,0,0,0,0,0,0,0,0,0,0,0,0,0,1,0,0,0,0,0,1,0,0,0,0,0,0,0,0,0,0,1,0,0,0,0,0,0,0,0,0,0,1,0,0,0,0,0,0,0,0,0,0,0,0,0,0,
        0,0,0,0,0,0,0,0,0,0,0,0,0,1,0,0,0,0,0,0,0,0,0,0,0,0,0,1,0,0,0,0,0,0,0,0,0,0,0,0,0,0,0,0,0,0,0,0,0,0,0,0,0,0,0,0,0,0,0,0,1,0,0,0,
        0,0,0,0,0,1,0,0,0,0,0,0,0,0,0,0,0,0,0,0,0,0,0,0,0,0,0,0,0,0,0,0,0,0,0,0,0,0,0,0,0,0,0,0,0,0,0,0,0,0,0,0,0,0,0,0,0,0,0,0,0,0,0,0,
        0,0,0,0,0,0,0,0,0,0,0,0,0,0,0,0,0,0,0,0,0,0,0,0,0,0,0,0,0,0,0,0,0,0,0,0,0,0,0,0,0,0,0,0,0,0,0,0,0,0,0,0,0,0,0,0,0,0,0,0,0,0,0,0,
        0,0,0,0,0,0,0,0,0,0,0,0,0,0,0,0,0,0,0,0,0,0,0,0,0,0,0,0,0,0,0,0,0,0,0,0,0,0,0,0,0,0,0,0,0,0,0,0,0,0,0,0,0,0,0,0,0,0,0,0,0,0,0,0,
        0,0,0,0,0,0,0,0,0,0,0,0,0,0,0,0,0,0,0,0,0,0,0,0,0,0,0,0,0,0,0,0,0,0,0,0,0,0,0,0,0,0,0,0,0,0,0,0,0,0,0,0,0,0,0,0,0,0,0,0,0,0,0,0,
        0,0,0,0,0,0,0,0,0,0,0,0,0,0,0,0,0,0,0,0,0,0,0,0,0,0,0,0,0,0,0,0,0,0,0,0,0,0,0,0,0,0,0,0,0,0,0,0,0,0,0,0,0,0,0,0,0,0,0,0,0,0,0,0,
        0,0,0,0,0,0,0,0,1,0,0,0,0,0,0,0,0,0,0,0,0,0,0,0,0,0,0,0,0,0,0,0,0,0,0,0,0,0,0,0,0,0,0,0,0,0,0,0,0,0,0,0,0,0,0,0,0,0,0,0,0,0,0,0,
        0,0,0,0,0,0,0,0,0,1,0,0,0,0,0,0,0,0,0,0,0,0,0,0,0,0,0,0,0,0,1,0,0,0,0,0,0,0,0,0,0,0,0,0,0,0,0,1,0,0,0,0,0,0,0,0,0,0,0,0,0,0,0,0,
        0,0,0,0,0,0,0,0,0,0,0,0,0,0,0,0,0,0,0,0,1,0,0,0,0,0,0,0,0,0,0,0,0,0,0,0,0,0,0,0,0,0,1,0,0,0,0,0,0,0,0,0,0,0,0,0,0,0,0,0,0,0,0,0,
        0,0,0,0,0,0,0,0,0,0,0,0,0,0,0,0,0,0,0,0,0,0,0,0,0,0,0,0,0,0,0,0,0,0,1,0,0,0,0,0,0,0,0,0,0,0,0,0,0,0,0,0,0,0,0,0,1,0,0,0,0,0,0,0,
        0,0,0,0,0,0,0,0,0,0,0,0,0,0,0,0,0,0,0,0,0,0,0,0,0,0,0,0,0,0,0,0,0,0,0,0,0,0,0,0,0,0,0,0,0,0,0,0,0,0,0,0,0,0,0,0,0,0,0,0,0,0,0,0,
        0,0,0,0,0,0,0,0,0,0,0,0,0,0,0,0,0,0,0,0,0,0,0,0,0,0,0,0,0,0,0,0,0,0,0,0,0,0,0,0,0,0,0,0,0,0,0,0,0,0,0,0,0,0,0,0,0,0,0,0,0,0,0,0,
        0,0,0,0,0,0,0,0,0,0,0,0,0,0,0,0,0,0,1,0,0,0,1,0,0,0,0,0,0,0,0,0,0,0,0,0,0,0,0,0,0,0,0,0,0,0,0,0,0,0,0,0,0,0,0,0,0,1,0,0,0,0,0,0,
        0,0,0,0,0,0,0,0,0,0,0,0,0,0,0,0,0,0,0,0,0,0,0,0,0,0,0,0,0,0,0,0,0,0,0,0,0,0,0,0,0,0,0,0,0,0,0,0,0,0,0,0,0,0,0,0,0,0,0,0,0,0,0,0,
        0,0,0,0,0,0,0,0,0,0,0,0,0,0,0,0,0,0,0,0,0,0,0,0,0,0,0,0,0,0,0,0,0,0,0,0,0,0,0,0,0,0,0,0,0,0,1,0,0,0,0,0,0,0,0,0,0,0,0,0,0,0,0,0,
        0,0,0,0,0,0,0,0,0,0,0,0,0,0,0,1,0,0,0,0,0,0,0,0,0,0,0,0,0,0,0,0,0,0,0,0,0,0,0,0,0,0,0,0,0,0,0,0,0,0,0,0,1,0,0,0,0,0,0,0,0,0,0,0,
        0,0,0,0,0,1,0,0,0,0,0,0,0,0,1,0,0,0,0,0,0,0,0,0,0,0,0,1,0,0,0,0,0,0,0,0,0,0,0,0,0,0,0,0,0,0,0,0,1,0,0,0,0,0,0,0,0,0,0,0,0,0,0,0
    ],

    "details": [
        {"x": 22, "y": 6, "type": 1},
        {"x": 36, "y": 6, "type": 1},
        {"x": 49, "y": 6, "type": 1},
        {"x": 53, "y": 11, "type": 1},
        {"x": 8, "y": 12, "type": 1},
        {"x": 38, "y": 14, "type": 1},
        {"x": 62, "y": 15, "type": 1},
        {"x": 19, "y": 18, "type": 1},
        {"x": 48, "y": 17, "type": 1},
        {"x": 2, "y": 20, "type": 1},
        {"x": 56, "y": 22, "type": 1},
        {"x": 31, "y": 25, "type": 1},
        {"x": 15, "y": 29, "type": 1},
        {"x": 23, "y": 32, "type": 1},
        {"x": 39, "y": 31, "type": 1},
        {"x": 60, "y": 34, "type": 1},
        {"x": 15, "y": 37, "type": 1},
        {"x": 29, "y": 37, "type": 1},
        {"x": 3, "y": 42, "type": 1},
        {"x": 52, "y": 44, "type": 1},
        {"x": 13, "y": 47, "type": 1},
        {"x": 20, "y": 45, "type": 1},
        {"x": 38, "y": 46, "type": 1},
        {"x": 9, "y": 54, "type": 1},
        {"x": 20, "y": 55, "type": 1},
        {"x": 30, "y": 54, "type": 1},
        {"x": 56, "y": 56, "type": 1},
        {"x": 5, "y": 63, "type": 1},
        {"x": 27, "y": 63, "type": 1},
        {"x": 48, "y": 63, "type": 1},

        {"x": 4, "y": 5, "type": 2},
        {"x": 17, "y": 5, "type": 2},
        {"x": 12, "y": 22, "type": 2},
        {"x": 27, "y": 20, "type": 2},
        {"x": 37, "y": 20, "type": 2},
        {"x": 46, "y": 28, "type": 2},
        {"x": 51, "y": 25, "type": 2},
        {"x": 7, "y": 37, "type": 2},
        {"x": 46, "y": 35, "type": 2},
        {"x": 53, "y": 35, "type": 2},
        {"x": 34, "y": 41, "type": 2},
        {"x": 27, "y": 46, "type": 2},
        {"x": 60, "y": 47, "type": 2},
        {"x": 42, "y": 55, "type": 2}
    ]
}